#.########
#.#.#....#
#.#.#.####
#...#....#
##.###.###
#...#....#
###...#.##
#.#.#.#..#
#...#.#..#
########.#