#.########
#...#....#
#.#.#.####
#.#.#....#
#.######.#
#........#
###.#.####
#.#.#.#..#
#...#....#
########.#