#.########
#........#
#.###.####
#...#....#
##.#######
#...#....#
#.###.##.#
#...#.#..#
#.#...#..#
########.#