#.########
#...#....#
###.#.####
#...#....#
#.####.###
#...#....#
###.#.##.#
#.#.#.#..#
#.....#..#
########.#