#.########
#.#.#....#
#.#...#.##
#...#.#..#
##.####.##
#...#....#
#.###.##.#
#...#.#..#
#.#.#.#..#
########.#