#.########
#.#.#....#
#.#...####
#...#....#
##.###.###
#...#....#
#.###.#.##
#.#.#.#..#
#...#.#..#
########.#